S.XR.B.H..
.X...X..HG
..H.XR..X.
..R...X...
X.XB.H..X.
.H.X...H..
..X.R.X...
H.....B.X.
..X.HR.X..
...GX...HG
